####################
#M      # #   # # ##
####### # # # # # ##
# #   # # #   #    #
### ### ### ########
# # #   #   # # #  #
# # # ####### ### ##
#   # #       # # ##
### ####### # ### ##
# #     #   # #    #
##### ### # # ### ##
# # #   #   # #   ##
##### ##### # ### ##
#      E  # # # #  #
# ### ### # ########
#   #   # #   #    #
# ########### # # ##
# #   #     # # #  #
####### # ### # # ##
####################

